NO textures/sunset.xpm
SO textures/lake.xpm
WE textures/ruins.xpm
EA textures/mountain.xpm
FL textures/floor.xpm
CE textures/ceiling.xpm

F 220,100,50
C 225,30,50

111111111111111
100000000000001
101111111110101
101000000010101
101011111010101
100000001010001
101011101010101
101000001000101
101011111110101
1E0000000000001
111111111111111