NO textures/sunset.xpm
SO textures/lake.xpm
WE textures/ruins.xpm
EA textures/mountain.xpm
FL textures/floor.xpm
CE textures/ceiling.xpm

F 220,100,0
C 225,30,0

111111111111111
100000000000001
101111111110101
101000000010101
101011111010101
101010001010101
101010101010101
101010101010101
101010100010101
101010111110101
101N00000000001
111111111111111
