NO textures/sunset.xpm
SO textures/lake.xpm
WE textures/ruins.xpm
EA textures/mountain.xpm
FL textures/floor.xpm
CE textures/ceiling.xpm

F 220,100,0
C 225,30,0

1111111111111111111
1000000000000000001
1011111111111111101
1010000000000000101
1010111111111110101
1010100000000010101
1010101111111010101
1010101000001010101
1010101011101010101
1010101010101010101
1010101010101010101
1010101000101010101
1010101111101010101
1010100000001010101
1010111111111010101
1010000000000010101
1011111111111110101
10000000000000001N1
1111111111111111111
