NO textures/sunset.xpm
SO textures/lake.xpm
WE textures/ruins.xpm
EA textures/mountain.xpm

F 164,169,20
C 153,204,255

111111111111111111111
100000000000000000001
100000000000000000001
100000000000000000001
100000000010000000001
100000000110000000001
100000001111000000001
100000011111100000001
100001111111111000001
100111111111111111001
100011111111111110001
100001111111111100001
100000111111111000001
100000011111110000001
100000001111100000001
100000000111000000001
100000000010000000001
1000N0000000000000001
100000000000000000001
100000000000000000001
111111111111111111111
