NO textures/sunset.xpm
SO textures/lake.xpm
WE textures/ruins.xpm
EA textures/mountain.xpm

F 164,169,20
C 153,204,255

111111111111111111111
100000000000000000001
100000000000000000001
100000000100000000001
1000 0000000000000001
1001N0000000000000001
100000000000000000001
111111111111111111111
