NO textures/sunset.xpm
SO textures/lake.xpm
WE textures/ruins.xpm
EA textures/mountain.xpm
FL textures/floor.xpm
CE textures/ceiling.xpm

F 164,169,120
C 153,204,255

111111111111
100000000001
101001                   
100000000001
10000001
10N001000001
100001
111111111111
