NO textures/sunset.xpm
SO textures/lake.xpm
WE textures/ruins.xpm
EA textures/mountain.xpm
FL textures/floor.xpm
CE textures/ceiling.xpm

F 164,169,120
C 153,204,255

111111111111111111111
100000000000000000001
101000000000000010001
100000000000000000001
100000000000000000001
10NSWN000000000000001
100000000000000000001
100111111111111111111
1001
1001
1001
1001
1001
1111
