NO textures/sunset.xpm
SO textures/lake.xpm
WE textures/ruins.xpm
EA textures/mountain.xpm
FL textures/floor.xpm
CE textures/ceiling.xpm


111111111111111111111
100000000000000000001
101000000001000010001
100000000000000000001
100000100000000000001
10N000000000001000001
100000000000000000001
100111111111111111111
1001
1001
1001
1001
1001
1111
